11,10
01111111111
10000000001
10101010101
10010101001
10000100001
10001010001
10010101001
10101010101
10000000001
11111111110