11, 11
01000100010
01010101010
01010101010
01010101010
01010101010
01010101010
01010101010
01010101010
01010101010
01010101010
10101010101
