20, 20
00000000000000000011
01000000101100101011
01001100100100100110
00100010011001001010
00011001001000110010
00011001001000011000
00110010101001100100
01001000100110010010
01011110111011110110
01100100111011110110
01100100111011001000
01000100100100010010
01111001001110111100
00111111110010011100
01001000100100010010
00010001001001000100
00001001000100100011
00010001001000101110
01100000110100110010
00000000000000000000
